####################
#..................#
#..###..####..###..#
#..................#
#.###..#....#..###.#
#......#....#......#
###..#..######..#..#
#....#........#....#
#..######..######..#
#..................#
#..######..######..#
#....#........#....#
###..#..######..#..#
#......#....#......#
#.###..#....#..###.#
#..................#
#..###..####..###..#
#..................#
####################